#000000000000000000000000000000000
#000000000000000000000000000000000
#000000000000000000000000000000000
#000000000000000000000000000000000
#000000000000000000000000000000000
#000000000000000000000000000000000
#000000000000000000000000000000000
#000000000000000000000000000000000
#0000000000000000000000000000E0000
#00000000000000000000000000000000E
#000000000000000000000000000000###
#00000000000000000W00000E000######
#000000##0000000##################
#########000000###################
##################################