1000000000000000000000000000000000
1000000000000000000000000000000000
1000000000000000000000000000000000
1000000000000000000000000000000000
1000000000000000000000000000000000
1000000000000000000000000000000000
1000000000000000000000000000000000
1000000000000000000000000000000000
1000000000000000000000000000000000
1000000000000000000000000000000000
1000000000000000000000000000000111
1000000000000000000000000000111111
1000000110000000111111111111111111
1111111110000001111111111111111111
1111111111111111111111111111111111